level 2
next_level assets/level_1.map
map
# # D # # -1
# M 0 M # -1
# 0 0 0 # -1
# 0 S 0 # -1
# # # # # -2